NO ./textures/north.xpm
SO ./textures/south.xpm
WE ./textures/west.xpm
EA ./textures/east.xpm
F 220,100,0
C 225,30,0
111111111111111
1000N000000001
1111000000000011
   100000000000011
111100000000001
100000000000011
 1000000000000111
111111111111111
