NO ./textures/north.xpm
SO ./textures/south.xpm
WE ./textures/west.xpm
EA ./textures/east.xpm
F 220,100,0
C 225,30,0




          1111111
         100000001
        10000000001
       1000000000001
      100000000000001
     10000000000000001
    1000000000000000001
   100000011111110000001
  10000001       10000001
 10000001         10000001
10000001           10000001
10000001           10000001
10000001           10000001
 10000001         10000001
  10000001       10000001
   100000011111110000001
    1000000000000000001
     10000000000000001
      100000000000001
       100000N000001
        10000000001
         100000001
          1111111
