NO ./textures/north.xpm
SO ./textures/south.xpm
WE ./textures/west.xpm
EA ./textures/east.xpm
F 220,100,0
C 225,30,0
              111
10000000000000101
1111111111111110011
111110000011110N001
          10000001
          1111111
