NO ./textures/north.xpm
SO ./textures/south.xpm
WE ./textures/west.xpm
EA ./textures/east.xpm
F 220,100,0
C 225,30,0
11111111111
10000000001
10011100001
101  100001
101  100001
101  100001
10011000001
100000000E1
11111111111
