NO ./textures/north.xpm
SO ./textures/south.xpm
WE ./textures/west.xpm
EA ./textures/east.xpm
F 99,88,10
C 10,30,10
  1111111
1100N001
1111111
