NO ./textures/north.xpm
SO ./textures/south.xpm
WE ./textures/west.xpm
EA ./textures/east.xpm
F 90,8,10
C 0,244,11
  1111111
1100S001
1111111
